pf_per_gulf_coast = {
	398 397 2333 395 396 2347 394 2340 408 412 430 4332 2219 431 2999
}

pf_afg_expansion_claims = {
	2229 447 449 2225 448 451 2226 578 2228 450 2227 452
}

pf_bal_expansion_claims = {
	434 2233 2232 575 576 2231 577 2068 2072 505 4505
}

pf_kho_expansion_claims = {
	427 2214 2236 2235 4326 2221 2350 4325 445 444 2349 437 438
}

pf_khu_expansion_claims = {
	2211 2210 2209 413 4290 4289 412 4291
}

pf_tab_expansion_claims = {
	4341 426 2215 417 4338 4339 2212 4300 4340 424
}