pf_per_gulf_coast = {
	398 397 2333 395 396 2347 394 2340 408 412 430 4332 2219 431 2999
}

pf_afg_expansion_claims = {
	2229 447 449 2225 448 451 2226 578 2228 450 2227 452
}

pf_bal_expansion_claims = {
	434 2233 2232 575 576 2231 577 2068 2072 505 4505
}

pf_kho_expansion_claims = {
	427 2214 2236 2235 4326 2221 2350 4325 445 444 2349 437 438 441
}

pf_khu_expansion_claims = {
	2211 2210 2209 413 4290 4289 412 4291
}

pf_tab_expansion_claims = {
	4341 426 2215 417 4338 4339 2212 4300 4340 424
}

pf_bab_expansion_claims = {
	408 4288 2312 2311 410 409 2310 406
}

pf_asy_expansion_claims = {
	2314 2309 411 407 4292 418 4295 4296 2306 2307 2308
}

pf_tig_expansion_claims = {
	415 4294 4293 2207 2206 416 4304
}

pf_csp_expansion_claims = {
	421 4299 4305 2202 2205 420 419 4302
}

pf_clc_expansion_claims = {
	2203 423 4301 422 462 1856 2204 2196 4303 331
}

pf_mga_expansion_claims = {
	4286 400 4287 403 4285 399 398 404 397 2333 395 396 2347 394 2340
}

pf_rjt_expansion_claims = {
	513 514 2067 4506 2088 4503 4504 504 503 2053 4480 4456 2052
}

pf_gjr_expansion_claims = {
	521 4454 515 4455 2051 4457 2054 4512 516 517 4430
}

pf_paj_expansion_claims = {
	512 4507 4513 4510 4508 506 4509 2086 2079
}

pf_ksm_expansion_claims = {
	2076 4511 2078 2077 4449 508 2073 4521 2074
}

pf_amy_expansion_claims = {
	458 1968 1967 4344 4343 454 453 442
}
